Albrecht Durer : Melencolia I 
Alfred Sisley: La neige a Louveciennes
Amedeo Modigliani: Alice
Andrei Rublev: La trinidad
Andy Warhol: Sopas Campbell
Camille Pissarro: El Sena en Bougival
Caravaggio:  Los discípulos de Emaús
Claude Monet: Impresión, sol naciente
Diego Rivera: La creación
Diego Velazquez: Las meninas
Edgar Degas: Ensayo de ballet
Edouard Manet: Almuerzo sobre la hierba
Edvard Munch: El grito
El Greco: El caballero de la mano en el pecho
Eugene Delacroix: La libertad guiando al pueblo
Francisco de Goya: El 3 de mayo en Madrid
Frida Kahlo: Autorretrato con mono
Georges Seurat: Tarde de domingo en la isla de la Grande Jatte
Giotto di Bondone: Prendimiento de Jesús
Gustav Klimt: El beso
Gustave Courbet: Entierro en Ornans
Henri de Toulouse Lautrec: La payasa Cha-U-Kao
Henri Matisse: La habitación roja
Henri Rousseau: El sueño
Hieronymus Bosch: El jardín de las delicias
Jackson Pollock: Lo profundo
Jan Van Eyck: Retrato de Giovanni Arnolfini y su esposa
Joan Miro: La sonrisa de alas flameantes 
Kazimir Malevich: Composición suprematista
Leonardo da Vinci: La mona Lisa
Marc Chagall: Yo y la aldea
Michelangelo: El juicio final (capilla sixtina)
Mikhail Vrubel: Demonio sentado en el jardin
Pablo Picasso: Guernica
Paul Cezanne: La montaña Sainte-Victoire vista desde Bibémus
Paul Gauguin: Somnolencia deliciosa
Paul Klee: The twittering machine
Peter Paul Rubens: Las tres gracias
Pierre Auguste Renoir: Niñas en negro
Piet Mondrian: Victory Boogie-Woogie
Pieter Bruegel: El triunfo de la muerte
Raphael: Virgen del prado
Rembrandt: La ronda de noche
Rene Magritte: Ceci nest pas une pipe
Salvador Dali: La persistencia de la memoria
Sandro Botticelli: El nacimiento de Venus
Titian: Venus del Prado
Vasiliy Kandinski: Composición X
Vincent van Gogh: La noche estrellada
William Turner: Fishermen at Sea